..#########
........#S#
#.###.###.#
#.#.....#.#
###.#.###.#
#.#.#...#.#
#.###.###.#
#.........#
#.###.###.#
#.#F#.#...#
#.#.#.#.###
#...#.#.#.#
#######.#.#
#.........#
#########.#