...################
...#.S#........#..#
#..#..#..####..#..#
#........#..#.....#
#######..#..####..#
#........#........#
#############..####
#.....#...........#
#..#..##########..#
#.F#..#..#..#..#..#
####..#..#..#..#..#
#.................#
################..#